Eins - um
Drei - três
Vier - quatro
Fünf - cinco
Sechs - seis
Sieben - sete 
Acht - oito
Neun - nove
Zehn - dez
Abend noch – boa noite (tal como: gutten tag)
Aber – mas
Ahnung – ideia
Also – então
Apfelstrudel – strudel de maça (bolo)
Apotheke – farmácia
Arzt – médico
Arztin – médica
Auch – também
Auf Wiedersehen – até logo
Backerei – padaria
Backerin – padeira
Badezimmer – casa de banho
Bahnhof – estação de comboios
Bald – breve
Bar – à vista
Beide – ambos
Bedeutet – significa
Bekomme – recebo
Bekommen – receber
Beliebt – popular
Besuchen – visitar
Besser – melhor
Bibliothek – biblioteca
Bilig – barato
Bis – até
Bist – estás
Bitte – por favor
Bordkarte – cartão de embarque
Brav – bem comportado
Bringe – trago
Bringen – trazer
Bringt – traz
Brot – pão
Bruder – irmão
Buch – livro
Café – cafetaria
Cool – simpáticos
Da drüben – ali
Danke – obrigado
Das – isso
Das ist – esta é
Dein – seu
Deine – sua
Dem – sobre
Der – o
Die – a
Draußen – fora
Du – você
Durstig – sedento
Empfehlen – recomenda
Entschuldigung – desculpa
Er – ele
Faul – preguiçoso
Fahren – ir
Fieber – febre
Findem – acham
Findest – achas
Fisch – peixe
Fliegen – voar
Fliegst – voas
Fliegt – voa
Flug – voo
Flughafen – aeroporto
Flugnummer – número de voo
Flugzeug – avião
Frage – pergunta
Frau – esposa
Frech – atrevido
Freien – livre
Freund – amigo
Freundin – amiga
Freut mich – prazer em conhecer
Ganz – bem
Garten – jardim
Gehe – vou
Gehen – ir
Geht – vai
Geht's – vai
Gemuse – legumes
Gemutlich – acolhedor
Geöffnet – aberta
Glaube – acredito
Groß – grande
Gut – bom
Guck mal – olha
Habe – tenho
Haben – ter
Hahnchen – frango assado
Handen – mãos
Handy – telemóvel
Hast – tens
Hat – tem
Hause – casa
Heiße – chamo-me
Hei$e(heiße) – chamo-me (eu chamo-me)
Hell – claro
Herr – senhor
Hier – aqui
Hilfe – ajuda
Höflich – educado
Hotel – hotel
Hund – cachorro
Hungrig – esfomeado
Husten – tosse
Ich bin – eu sou
Ich komme aus – eu venho de
Ihr – seu
Imbiss – lanchonete
Ins – ir ao
Interessant – interessante
Ist – é
Ist das – esse é
Ja – sim
Jacke – jaqueta
Jetzt – agora
Joggen – correr
Kaffee – café
Kaninchen – coelho
Karte – cartão
Kassa – caixa
Katze – gato
Käse – queijo
Kaufen – comprar
Kaufe – compro
Kaufst – compras
Kekse – biscoitos
Kellner – garçom
Kellnerin – garçonete
Keine – não
Klein – pequeno
Kochen – cozinhar
Kocht – cozinha
Koffer – mala
Komisch – estranho
Kosten – custar
Krank – doente
Kreativ – criativo
Kuchen – bolo
Kunst – arte
Lampe – lâmpada
Laut – alto
Lecker – saboroso
Leer – vazio
Lehrer – professor
Lehrerin – professora
Lieben – adorar
Liebst – adoras (tu)
Liebt – adora (ele/ela)
Links – esquerda
Los – está acontecendo
Lustig – divertido
Mach's gut – fica bem
Machen – fazer
Machst du – tu fazes
Mama – mãe
Mann – marido
Mathe – matemática
Mehr – mais
Mein – meu
Meine – minha
Milch – leite
Mit – com
Mitbewoher – colega de quarto
Mitbewoherin – colega de quarto
Mobel – móveis
Mochte – gostaria (eu)
Mochten – gostariamos (nós) / gostaria (a Sra/Voce/formal)
Mochtest – gostarias (tu)
Mogen – gostar
Moment – momento
Müde – cansado
Musik – música
Musiker – músico
Nach – para
Neheme – vou levar
Nein – não
Nett – fixe
Neu – novo
Neue – nova
Nicht – não
Nie – nunca
Noch etwas – mais alguma coisa
Obst – frutas
Oder – ou
Oft – frequentemente
Park – parque
Party – festa
Pferd – cavalo
Pflanze – planta
Pilot – piloto
Pilotin – piloto
Praktish – prática
Problem – problema
Pünktlich – pontual
Rechnung – conta
Rechts – direita
Reservierung – reserva
Rezept – receita
Richtig – certo
Riechen – cheirar
Riecht – cheira
Rote – vermelha
Ruhe – calma
Salat – salada
Satt – satisfeito
Sauber – limpo
Schade – que pena
Schatz – meu amor / tesouro
Scharf – picante
Schlecht – mal
Schmecken – saber
Schmeckt – tem gosto
Schmerzen – dores
Schmutzig – sujo
Schön – bonita
Schon – já
Schwach – fraco
Schwarze – preta
Schwester – irmã
Schwer – pesado
Schwimmen – nadar
Sehe – vejo
Sehen – ver
Sehr – muito
Shonen abend noch – tenha uma boa noite
Sie – ela
Sind – estamos
So – tão
Sohn – filho
Sofa – sofá
Spät dran – atrasado (verspatet -> para transportes; + formal)
Speisekarte – menu de restaurante (ou Tagesmenü)
Spielen – jogar
Spielst du – jogas tu
Sport – desporto
Sportlich – desportivo
Stadt – cidade
Stressig – stressante
Stuhl – cadeira
Studieren – estudar
Suche – procuro
Suchen – procurar
Suchst – procuras
Sucht – procura
Suppe – sopa
Süß – doce
Taxi – táxi
Tee – chá
Tennis – ténis
Teuer – cara
Tepich – tapete
Termin – compromisso
Tisch – mesa
Tochter – filha
Toilette – casa de banho
Trinke – bebo
Trinken – bebemos
Trinkst – bebes
Tschüss – adeus
U-Bahn – metro
Universität – universidade
Vegetarisch – vegetariana
Verkäuferin – vendedora
Verspatet – atrasado (para transportes; + formal)
Viel – muito
Voll – cheio
Wandern – caminhar
Wandert – caminha
Warm – quente
Warum – porquê
Was – qual
Wasser – água
Weg – desapareceu
Wein – vinho
Wie – como
Wie geht's – como vai
Wir – nós
Wirklich – realmente
Wo – onde
Wohnen – morar
Wohnst – moras
Wohnt – mora
Wohnung – apartamento
Wohnzimmer – sala
Wunderbar – maravilhoso
Wurst – salsicha
Yoga – ioga
Zahle – pago
Zahlen – pagamos
Zu – muito
Zucker – açúcar
Zufrieden – contentes
Zuhause – em casa
Zwei – dois
Kleidung - roupa
Genau - exato / exatamente
Hasslich - feio / feia / feios(as)
Flohmarkt - mercado de pulgas
Nahe - perto
Nur - só
Langweilig - sem graça
Radio - rádio (aparelho)
Foto - fotografia
Flasche - garrafa 
Flaschen - garrafas
Taschen - bolsas (mala de senhora)
Jacken - jaqueta
Kappe - boné (cap em ingles)
Schick - elegante